The Arena
32
32
################################
################################
################################
############........############
##########............##########
########................########
#######..................#######
######....................######
#####......................#####
#####......................#####
####........................####
####........................####
###..........................###
###..........................###
###..........................###
###..........................###
###..........................###
###..........................###
###..........................###
###..........................###
####........................####
####........................####
#####......................#####
#####......................#####
######....................######
#######..................#######
########................########
##########............##########
############........############
################################
################################
################################