The Arena
16
16
################
#####......#####
###..........###
##............##
##............##
#..............#
#..............#
#..............#
#..............#
#..............#
#..............#
##............##
##............##
###..........###
#####......#####
################