My Test Map!
10
8
##########
#.......##
#####....#
###....###
#........#
####..####
#......###
##########